R 500 500
F 145,54,  5
C   210   ,215        ,54
NO          link1
SO link1
EA link1
WE link1
S obj1


1111111
1000001
1000001
1000001
1111111
1111111
1000001
1000001
1000001
1111111
   
   