R 8000 600
F 255,229,1
C   185   ,138, 1
NO          /home/user42/Documents/cub3d/textures/wood.xpm
SO /home/user42/Documents/cub3d/textures/redbrick.xpm
EA /home/user42/Documents/cub3d/textures/sand.xpm
WE /home/user42/Documents/cub3d/textures/stone.xpm
S obj2

11111111111
10000000001              
10000000001              
10000000001
101000100011
100000000011111111111111111111
10000E00000000000000000011111
1000000000000000011111111111
10000000000111111
1111111111111