R 2147483647 2147483648
F 145,255,255
C   210   ,215,54
NO          link3
SO link1
EA link1
WE link1
S obj2

1111111111111
1000010000001
1000010000001
10000N0000001
10000000000011
1000000000111
1111111111