R 800 600
F 10,255,255
C   210   ,215,54
NO          link3
SO link1
EA link1
WE link1
S obj2

1111111111111
1000010000001
1000010000001
10100000100011
100000000000111
100001000000011111
1000000000000000001
1000010000000000111
100N0000000000000001
1000000000000111111
111111111111111