R 800 600
F 10,255,255
C   210   ,215,54
NO          /home/user42/Documents/cub3d/textures/mossy.xpm
SO /home/user42/Documents/cub3d/textures/redbrick.xpm
EA /home/user42/Documents/cub3d/textures/sand.xpm
WE /home/user42/Documents/cub3d/textures/stone.xpm
S obj2

1111111111111
1000010000001
1000010000001
10100000100011
100000000000111111111111111111111111111
1000000000000000000000000000000000000011111
100000000000000000000000000000000000001
1000010000000000000000000000000000000011
100N00000000000000011111111111111111111
1000000000000111111
111111111111111