R 500 500
F 145,54,  5
C   210   ,215        ,54
NO          link1
SO link1
EA link1
WE link1
S obj1

11111111
10000001
10000001
10000011
100S02001
1000000001
100111111111111
 11