R 800 600
F 100,29,1
C   111   ,202, 215  
NO          ./textures/wood.xpm
SO ./textures/sand.xpm
EA ./textures/redbrick.xpm
WE ./textures/stone.xpm
S ./textures/barrel.xpm

    111
    101
    101
    101
11111011111
10000000001              
10000200001              
10000000001
10100100011
100000000011111111111111111111
100000E20000000000000011111
10000000000200011101111111
1000000000111111  1  
1111111111111