R 500 500
F 145,54,  5
C   210   ,215        ,54
NO          link1
SO link1
EA link1
WE link1
S obj1

11111111
10000001
10000001
10000001
10000201
10000001
1001111111111111
100000000000000111111111111111111
10020000000200000000000000000000111111111111111111111111111111111111111111111111111111111
10000000000000000000000000000000000000000000002000000000000000000000000000000000000000001
10000000000000000000000000000020000000000000000001111111111111111111111111111111111111111
10020000000200011111111111111111111111111111111111
1000000000000001
1111100011111111
    10001
    10001
    1000111111111111111111111111111111111111111111111111111111111111111111111111111111111111111111111111111111111111111111111111111111111111111111111
    1020000000000000000000000000000000000000000000000000000000000000000000000000000000000000000000000000000000000000000000000000000000000000000000001
11111001111111111111111111111111111111111111111111111111111111111111111111111111111111111111111111111111111111111111111111111111111111111111111111111
10000001
10000001
10000201
10000201
10000001
1001111111111111
100000000000000111111111111111111
100020000000000000000000000000001
100000000002000000000000000200001
100200000000000111111111111111111
1000000000000001
1111100011111111
     111

