R 500 500
F 145,255,255
C   210   ,215,54
NO          link3
SO link1
EA link1
WE link1
S obj2


11111111
10000001
10000001
10000001
10000201
10000001
1001111111111111
100000000000000111111111111111111
10020000000200000000000000000000111111111111111111111111111111111111111111111111111111111
10000000000000000000000000000000000000000000002000000000000000000000000000000000000000001
10000000000000000000000000000020000000000000000001111111111111111111111111111111111111111
10020000000200011111111111111111111111111111111111
1000000000000001
1111100011111111
    10001
    10001
    11001
    1000111111111111111111111111111111111111111111111111111111111111111111111111111111111111111111111111111111111111111111111111111111111111111111111
    1020000000000000000000000000000000000000000000000000000000000000000000000000000000000000000000000000000000000000000000000000000000000000000000001
11111001111111111111111111111111111111111111111111111111111111111111111111111111111111111111111111111111111111111111111111111111111111111111111111111
10000001
10000001
10000201
10000201
10000001
1001111111111111
100000000000000111111111111111111
100020000000000000000000000000001
100000000002000000000000000200001
100200000000000111111111111111111
1000000000000001
1111100011111111
    10001
    10001
    10001
    10001
1111100011111111
100000000000000111111111111111111
10000000000000000000000000000000111111111111111111111111111111111111111111111111111111111
10020000000000000000000000020000000000000000000002000000000000000000000002000000000000001
10000000000000000000000000000000000000000000000001111111111111111111111111111111111111111
10000020000000011111111111111111111111111111111111
1000000000000001
1111100011111111
    10001
    10001
    10201   
    10001
111110011     11111       1111111
10000001      10111       100101
10020001      101         100101 
12000001       1         11111111
10000201
10000001
1001111111111111
100000200000000111111111111111111
100000000000000000000200000000001
100000000200000000000000000000201
120000000000000111111111111111111
1000000000000001
1111100011111111
    10001
    10001
    10201
    10001
    10001
    10001
    10001
    10001
1111100011111111
100000000000000111111111111111111
10020000000000000000000000000000111111111111111111111111111111111111111111111111111111111
10000000000000N00000000000020000000000000000000002000000000000000000000002000000000000001
1000000000000000000000000000000000000000000000001111111111111111111111111111111111111111
10000020000000011111111111111111111111111111111111
1000000000000001
1111100011111111
    10001
    10001
    10201
    10001
111110011
10000001
10000001
12000001
10000201
10000001
1111111111111111
10000020000000011111111111111111
100200000000000000000200000000001
100000000200000000000000000000201
120000000000000111111111111111111
1000000000000001
1111100011111111
    10001
    10001
    10201
    10001
    11111
 


 
  
   
    
     
      
        