R 1080 720 
F 145,255,255
C   210   ,215,54
NO          link3
SO link1
EA link1
WE link1
S obj2

11111111
1N000001
10000001
10000001
10000201
10000001
1001111111111111
10000000000000011111111
10000000000000000000001
10000000000000000011111
100200000002000111
 11110001111111
    10001
    100011111111111111
    102000000000000001
    100111111111111111
     11