R 800 600
F 10,255,255
C   210   ,215,54
NO          link3
SO link1
EA link1
WE link1
S obj2

1111111111111
1000010000001
1000010000001
10000N0000001
100000000000111
100000000000000111
111111111111111