R 800 600
F 100,29,1
C   111   ,202, 215  
NO          ./textures/wood.xpm
SO ./textures/sand.xpm
EA ./textures/redbrick.xpm
WE ./textures/stone.xpm
S ./textures/barrel.xpm

11111111111111111
10000000000000001
10002000000002001
10000000002000001
10000000000000001111111
10010000000000000000001
10000000200000000100001
100E0000000000000000001
10000000000000000000001
11111111111111111111111