R 8000 600
F 10,255,255
C   100   ,100,100
NO          /home/user42/Documents/cub3d/textures/stone.xpm
SO /home/user42/Documents/cub3d/textures/redbrick.xpm
EA /home/user42/Documents/cub3d/textures/sand.xpm
WE /home/user42/Documents/cub3d/textures/stone.xpm
S obj2

1111111111111
1000010000001
1000010000001
10100000100011
10000000000011111111111111111111
1000000E00000000000000000011111
100000000000000000011111111111
1000000000000111111
111111111111111